 		[[00, 00, 00, 00, 00, 00, 00, 00, 00, 00, 00, 00, 00, 00, 00, 00, 00, 00, 00, 00, 00, 00, 00, 00, 00, 00, 00, 00, 00, 00, 00, 00, 00, 00, 00, 00, 00, 00, 00, 00, 00, 00, 00, 01, 01, 01, 01, 01, 01, 01, 01, 01, 01, 01],
        [00, 00, 00, 00, 00, 00, 00, 00, 00, 00, 00, 00, 00, 00, 00, 00, 00, 00, 00, 00, 00, 00, 00, 00, 00, 00, 00, 00, 00, 00, 00, 00, 00, 00, 00, 00, 00, 00, 00, 00, 00, 00, 01, 01, 01, 01, 01, 01, 01, 00, 00, 00, 00, 01],
        [00, 00, 00, 00, 00, 00, 00, 00, 00, 00, 00, 00, 00, 00, 00, 00, 00, 00, 00, 00, 00, 00, 00, 00, 00, 00, 00, 00, 00, 00, 00, 00, 00, 00, 00, 00, 00, 00, 00, 00, 00, 01, 01, 00, 00, 00, 00, 00, 00, 00, 00, 00, 00, 01],
        [00, 01, 01, 01, 01, 01, 01, 01, 00, 00, 00, 01, 01, 01, 01, 01, 01, 01, 01, 01, 01, 01, 01, 01, 00, 00, 01, 01, 01, 01, 01, 01, 01, 01, 01, 01, 01, 01, 01, 01, 01, 01, 00, 00, 00, 00, 00, 00, 00, 07, 00, 00, 00, 01],
        [01, 01, 00, 00, 00, 00, 00, 01, 01, 01, 00, 01, 01, 00, 00, 00, 00, 00, 00, 01, 01, 00, 00, 01, 01, 00, 01, 00, 00, 00, 00, 00, 00, 00, 00, 00, 00, 00, 00, 00, 00, 00, 00, 00, 12, 00, 00, 00, 05, 00, 00, 00, 00, 01],
        [01, 00, 00, 06, 00, 00, 00, 00, 00, 01, 01, 01, 00, 00, 00, 00, 00, 00, 00, 00, 00, 00, 00, 00, 01, 01, 01, 00, 00, 00, 00, 00, 00, 00, 00, 00, 00, 00, 00, 00, 00, 00, 00, 00, 00, 00, 00, 00, 00, 00, 01, 01, 01, 01], 
        [01, 00, 00, 02, 00, 00, 00, 00, 00, 00, 00, 00, 00, 00, 00, 00, 00, 00, 00, 00, 00, 00, 00, 00, 00, 00, 00, 00, 00, 00, 00, 00, 00, 00, 01, 01, 01, 01, 00, 00, 00, 00, 00, 00, 00, 00, 00, 00, 00, 01, 01, 01, 00, 00], 
        [01, 00, 00, 00, 00, 00, 00, 00, 00, 00, 00, 00, 00, 00, 01, 01, 01, 01, 01, 00, 00, 00, 00, 00, 00, 00, 00, 00, 00, 00, 00, 00, 01, 01, 01, 00, 00, 01, 01, 00, 00, 00, 00, 00, 00, 00, 00, 01, 01, 01, 00, 00, 00, 00], 
        [01, 01, 00, 00, 00, 00, 00, 00, 00, 00, 00, 00, 00, 01, 01, 00, 00, 00, 01, 01, 12, 00, 00, 00, 00, 00, 00, 00, 00, 00, 00, 00, 01, 00, 00, 00, 00, 00, 01, 01, 01, 01, 00, 00, 00, 00, 01, 01, 00, 00, 00, 00, 00, 00], 
        [00, 01, 00, 00, 00, 00, 00, 00, 01, 01, 01, 01, 01, 01, 00, 00, 00, 00, 00, 01, 00, 00, 00, 00, 00, 00, 00, 00, 00, 00, 00, 00, 01, 01, 01, 01, 00, 00, 01, 00, 00, 01, 00, 00, 00, 00, 01, 00, 00, 00, 00, 00, 00, 00], 
        [01, 01, 00, 00, 00, 00, 00, 00, 01, 00, 00, 00, 00, 00, 00, 00, 00, 00, 00, 01, 00, 00, 00, 00, 00, 00, 00, 00, 00, 00, 00, 00, 00, 00, 00, 01, 00, 00, 01, 00, 00, 01, 01, 00, 00, 00, 01, 01, 00, 00, 00, 00, 00, 00], 
        [01, 00, 00, 00, 00, 00, 00, 00, 01, 01, 00, 00, 00, 00, 00, 00, 00, 00, 00, 01, 00, 00, 00, 00, 00, 00, 00, 00, 00, 00, 00, 00, 00, 00, 00, 01, 01, 01, 01, 01, 00, 01, 01, 00, 00, 00, 00, 01, 00, 00, 00, 00, 00, 00], 
        [01, 00, 00, 00, 00, 00, 00, 00, 01, 01, 00, 00, 00, 00, 00, 00, 00, 00, 00, 01, 01, 00, 00, 00, 00, 00, 00, 00, 00, 00, 00, 00, 00, 00, 12, 00, 00, 00, 01, 01, 01, 01, 01, 00, 00, 00, 00, 01, 01, 01, 00, 00, 00, 00], 
        [01, 01, 00, 00, 00, 00, 00, 00, 01, 00, 00, 00, 00, 00, 00, 00, 00, 00, 00, 00, 01, 00, 00, 00, 00, 00, 00, 00, 00, 00, 00, 00, 00, 00, 00, 00, 00, 00, 00, 00, 00, 01, 01, 01, 00, 00, 00, 00, 01, 01, 01, 01, 01, 01], 
        [00, 01, 01, 00, 00, 00, 00, 00, 01, 01, 00, 00, 00, 00, 00, 00, 00, 00, 00, 00, 01, 00, 00, 00, 00, 00, 00, 00, 00, 00, 00, 00, 00, 00, 00, 00, 00, 00, 00, 00, 01, 01, 01, 01, 01, 00, 00, 00, 00, 00, 01, 01, 01, 01], 
        [00, 00, 01, 00, 00, 00, 00, 00, 01, 01, 00, 00, 00, 00, 00, 00, 00, 00, 00, 01, 01, 00, 40, 41, 45, 00, 00, 00, 00, 00, 00, 00, 00, 00, 00, 00, 00, 00, 00, 01, 01, 00, 00, 01, 01, 01, 00, 00, 00, 00, 00, 00, 00, 01], 
        [00, 00, 01, 00, 00, 00, 00, 00, 01, 00, 00, 00, 00, 00, 00, 00, 00, 01, 01, 01, 00, 00, 42, 00, 00, 00, 00, 00, 00, 00, 00, 00, 00, 00, 00, 00, 00, 00, 00, 01, 00, 00, 00, 00, 00, 01, 00, 00, 00, 00, 00, 00, 00, 01], 
        [00, 01, 01, 00, 00, 00, 00, 00, 01, 01, 01, 00, 00, 00, 00, 00, 00, 01, 00, 00, 00, 00, 00, 00, 00, 00, 00, 00, 00, 00, 00, 43, 00, 00, 00, 00, 00, 00, 00, 01, 00, 00, 00, 00, 00, 01, 00, 00, 00, 00, 00, 00, 00, 01], 
        [00, 01, 00, 00, 00, 00, 00, 00, 00, 00, 01, 01, 00, 00, 00, 00, 00, 01, 00, 00, 00, 00, 00, 00, 00, 00, 00, 00, 00, 00, 00, 00, 00, 00, 00, 00, 00, 00, 00, 01, 00, 00, 00, 00, 00, 01, 00, 00, 00, 00, 00, 00, 00, 01], 
        [00, 01, 00, 00, 00, 13, 00, 00, 00, 00, 00, 01, 01, 01, 01, 01, 01, 01, 00, 00, 00, 00, 00, 00, 00, 00, 00, 08, 00, 00, 00, 00, 00, 00, 00, 00, 00, 00, 00, 01, 00, 00, 00, 00, 00, 01, 00, 00, 00, 00, 00, 00, 00, 01], 
        [00, 01, 00, 00, 00, 00, 00, 00, 00, 00, 00, 00, 00, 00, 01, 01, 00, 00, 00, 00, 00, 00, 44, 00, 00, 00, 00, 00, 00, 00, 00, 00, 00, 00, 00, 00, 00, 00, 00, 00, 01, 00, 00, 00, 01, 01, 00, 00, 00, 00, 00, 00, 00, 01], 
        [00, 01, 01, 00, 00, 00, 00, 00, 00, 00, 00, 00, 00, 00, 00, 00, 00, 00, 00, 00, 00, 00, 00, 00, 00, 00, 00, 11, 00, 00, 00, 00, 00, 00, 00, 00, 00, 00, 00, 00, 01, 01, 01, 01, 01, 00, 00, 00, 00, 00, 00, 00, 00, 01], 
        [00, 01, 01, 00, 00, 00, 00, 00, 00, 00, 00, 00, 00, 00, 00, 00, 00, 00, 00, 00, 00, 00, 00, 00, 00, 00, 00, 00, 00, 00, 00, 00, 00, 00, 00, 00, 00, 00, 00, 00, 00, 00, 00, 00, 00, 00, 00, 00, 00, 00, 00, 00, 00, 01], 
        [01, 01, 00, 00, 00, 00, 00, 00, 00, 00, 00, 00, 00, 00, 00, 00, 12, 00, 00, 00, 00, 00, 00, 00, 00, 00, 00, 00, 00, 00, 00, 00, 00, 00, 00, 00, 00, 00, 00, 00, 00, 00, 00, 00, 00, 00, 00, 00, 00, 00, 00, 01, 01, 01], 
        [01, 00, 00, 00, 00, 00, 00, 00, 00, 00, 00, 00, 00, 00, 00, 00, 00, 00, 00, 00, 00, 00, 00, 00, 00, 00, 00, 00, 00, 00, 00, 00, 00, 00, 00, 00, 01, 01, 01, 00, 00, 00, 00, 00, 00, 00, 00, 00, 00, 01, 01, 01, 01, 01], 
        [01, 00, 00, 00, 00, 00, 00, 00, 00, 00, 00, 01, 01, 01, 01, 01, 01, 01, 01, 00, 00, 00, 00, 00, 00, 00, 00, 00, 00, 00, 00, 00, 00, 00, 01, 01, 01, 00, 01, 01, 01, 01, 00, 00, 00, 00, 00, 00, 00, 01, 01, 00, 00, 00], 
        [01, 00, 00, 00, 00, 00, 00, 00, 00, 00, 01, 01, 00, 00, 00, 00, 00, 00, 01, 01, 00, 00, 00, 00, 00, 00, 00, 00, 00, 00, 00, 00, 00, 01, 01, 00, 00, 00, 00, 00, 00, 01, 00, 00, 00, 00, 00, 00, 00, 01, 00, 00, 00, 00], 
        [01, 00, 00, 00, 00, 00, 00, 00, 00, 01, 01, 00, 00, 00, 00, 00, 00, 00, 00, 01, 01, 00, 00, 00, 00, 00, 00, 00, 00, 00, 00, 00, 00, 00, 01, 01, 00, 00, 00, 00, 00, 01, 00, 00, 00, 00, 00, 00, 01, 01, 00, 00, 00, 00], 
        [01, 00, 00, 00, 00, 00, 00, 00, 00, 01, 00, 00, 00, 00, 00, 00, 00, 00, 00, 00, 01, 01, 00, 00, 00, 00, 00, 00, 00, 00, 00, 00, 00, 00, 00, 01, 01, 00, 00, 00, 00, 01, 00, 00, 00, 00, 00, 00, 01, 01, 00, 00, 00, 00], 
        [01, 00, 02, 00, 00, 00, 00, 00, 00, 01, 01, 00, 01, 01, 01, 01, 01, 01, 00, 00, 00, 01, 01, 01, 00, 00, 00, 00, 00, 00, 00, 00, 00, 00, 00, 00, 01, 00, 00, 00, 00, 01, 00, 00, 00, 00, 00, 00, 00, 01, 00, 00, 00, 00],
        [01, 00, 00, 12, 00, 00, 00, 00, 00, 00, 01, 01, 01, 00, 00, 00, 00, 01, 00, 00, 00, 00, 00, 01, 00, 00, 00, 00, 00, 00, 00, 00, 00, 00, 00, 00, 01, 00, 00, 00, 00, 01, 00, 00, 00, 00, 00, 00, 00, 01, 00, 00, 00, 00],
        [01, 00, 00, 00, 00, 00, 00, 00, 00, 00, 00, 00, 00, 00, 00, 00, 00, 01, 01, 01, 00, 00, 00, 01, 01, 01, 01, 00, 00, 00, 00, 00, 46, 00, 00, 00, 01, 01, 00, 00, 00, 01, 00, 00, 00, 00, 00, 00, 00, 01, 01, 00, 00, 00],
        [01, 01, 01, 01, 00, 00, 00, 00, 00, 00, 00, 00, 00, 00, 00, 00, 00, 00, 00, 01, 00, 00, 00, 00, 00, 00, 01, 01, 01, 01, 01, 01, 01, 00, 00, 00, 01, 01, 00, 00, 00, 01, 00, 00, 00, 00, 00, 00, 12, 00, 01, 00, 00, 00],
        [00, 00, 01, 01, 01, 01, 00, 00, 00, 00, 00, 00, 00, 00, 00, 00, 00, 00, 00, 01, 01, 01, 01, 00, 00, 00, 00, 00, 00, 00, 00, 01, 01, 01, 00, 00, 01, 00, 00, 00, 01, 01, 00, 00, 00, 00, 00, 00, 09, 00, 01, 00, 00, 00],
        [00, 00, 00, 00, 01, 01, 00, 00, 01, 01, 01, 01, 00, 00, 00, 00, 00, 00, 00, 00, 00, 00, 01, 01, 00, 00, 00, 00, 00, 00, 00, 00, 00, 01, 00, 00, 01, 00, 00, 01, 01, 00, 00, 00, 00, 00, 00, 00, 14, 00, 01, 00, 00, 00],
        [00, 00, 00, 00, 00, 01, 01, 01, 01, 00, 00, 01, 01, 01, 00, 00, 00, 00, 00, 00, 00, 00, 00, 01, 01, 00, 00, 00, 00, 00, 00, 01, 01, 01, 00, 00, 01, 01, 01, 01, 00, 00, 00, 00, 00, 00, 00, 00, 00, 00, 01, 00, 00, 00],
        [00, 00, 00, 00, 00, 00, 00, 00, 00, 00, 00, 00, 00, 01, 01, 01, 01, 00, 00, 00, 00, 00, 00, 00, 01, 01, 00, 00, 00, 00, 01, 01, 00, 00, 00, 00, 00, 00, 12, 00, 00, 00, 00, 00, 00, 00, 00, 00, 00, 01, 01, 00, 00, 00], 
        [00, 00, 00, 00, 00, 00, 00, 00, 00, 00, 00, 00, 00, 01, 00, 00, 01, 01, 00, 00, 00, 00, 00, 00, 00, 01, 01, 01, 01, 00, 01, 00, 00, 00, 00, 00, 00, 00, 00, 00, 00, 00, 00, 00, 00, 00, 00, 00, 00, 01, 00, 00, 00, 00], 
        [00, 00, 00, 00, 00, 00, 00, 00, 00, 00, 00, 00, 00, 00, 00, 00, 00, 01, 01, 00, 00, 00, 00, 00, 00, 00, 00, 00, 01, 01, 01, 00, 00, 00, 00, 00, 00, 00, 00, 00, 00, 00, 00, 00, 00, 00, 01, 01, 01, 01, 00, 00, 00, 00], 
        [00, 00, 00, 00, 00, 00, 00, 00, 00, 00, 00, 00, 00, 00, 00, 00, 00, 00, 01, 01, 01, 01, 00, 00, 00, 00, 00, 00, 00, 00, 00, 00, 00, 00, 00, 00, 00, 00, 00, 00, 00, 00, 00, 00, 00, 01, 01, 00, 00, 01, 00, 00, 00, 00], 
        [00, 00, 00, 00, 00, 00, 00, 00, 00, 00, 00, 00, 00, 00, 00, 00, 00, 00, 00, 00, 01, 01, 01, 01, 01, 00, 00, 00, 00, 00, 00, 00, 00, 00, 00, 00, 00, 00, 00, 00, 00, 00, 00, 00, 00, 01, 00, 00, 00, 00, 00, 00, 00, 00], 
        [00, 00, 00, 00, 00, 00, 00, 00, 00, 00, 00, 00, 00, 00, 00, 00, 00, 00, 00, 00, 00, 00, 00, 01, 01, 01, 00, 00, 00, 00, 30, 00, 00, 00, 00, 00, 00, 00, 00, 12, 00, 00, 00, 00, 01, 01, 00, 00, 00, 00, 00, 00, 00, 00], 
        [00, 00, 00, 00, 00, 00, 00, 00, 00, 00, 00, 00, 00, 00, 00, 00, 00, 00, 00, 00, 00, 00, 00, 00, 01, 01, 01, 00, 99, 00, 01, 01, 01, 01, 01, 01, 01, 01, 01, 01, 01, 01, 01, 01, 01, 00, 00, 00, 00, 00, 00, 00, 00, 00], 
        [00, 00, 00, 00, 00, 00, 00, 00, 00, 00, 00, 00, 00, 00, 00, 00, 00, 00, 00, 00, 00, 00, 00, 00, 00, 01, 01, 00, 00, 00, 01, 00, 00, 00, 00, 00, 00, 00, 00, 00, 00, 00, 00, 00, 00, 00, 00, 00, 00, 00, 00, 00, 00, 00],
        [00, 00, 00, 00, 00, 00, 00, 00, 00, 00, 00, 00, 00, 00, 00, 00, 00, 00, 00, 00, 00, 00, 00, 00, 00, 01, 01, 00, 95, 00, 01, 00, 00, 00, 00, 00, 00, 00, 00, 00, 00, 00, 00, 00, 00, 00, 00, 00, 00, 00, 00, 00, 00, 00]];