			[00, 00, 00, 00, 00, 00, 00, 00, 00, 00, 00, 00, 00, 00, 00, 00, 00, 00, 00, 00, 00, 00, 00, 00, 00, 00, 00, 00, 00, 00, 00, 00, 00, 00, 00, 00, 00, 00, 00, 00, 00, 00, 00, 01, 01, 01, 01, 01, 01, 01, 01, 01, 01, 01],
 			[00, 00, 00, 00, 00, 00, 00, 00, 00, 00, 00, 00, 00, 00, 00, 00, 00, 00, 00, 00, 00, 00, 00, 00, 00, 00, 00, 00, 00, 00, 00, 00, 00, 00, 00, 00, 00, 00, 00, 00, 00, 00, 01, 01, 01, 01, 01, 01, 01, 00, 00, 00, 00, 01],
			[00, 00, 00, 00, 00, 00, 00, 00, 00, 00, 00, 00, 00, 00, 00, 00, 00, 00, 00, 00, 00, 00, 00, 00, 00, 00, 00, 00, 00, 00, 00, 00, 00, 00, 00, 00, 00, 00, 00, 00, 00, 01, 01, 00, 00, 00, 00, 00, 00, 00, 00, 00, 00, 01],
			[00, 01, 01, 01, 01, 01, 01, 01, 01, 01, 01, 01, 01, 01, 01, 01, 01, 01, 01, 01, 01, 01, 01, 01, 01, 01, 01, 01, 01, 01, 01, 01, 01, 01, 01, 01, 01, 01, 01, 01, 01, 01, 00, 00, 00, 00, 00, 00, 00, 00, 00, 00, 00, 01],
			[01, 01, 00, 00, 00, 00, 00, 00, 00, 00, 00, 00, 00, 00, 00, 00, 00, 00, 00, 00, 00, 00, 00, 00, 00, 00, 00, 00, 00, 00, 00, 00, 00, 00, 00, 00, 00, 00, 00, 00, 00, 00, 00, 00, 00, 05, 07, 00, 00, 00, 00, 00, 00, 01],
			[01, 00, 00, 00, 00, 00, 00, 00, 00, 00, 00, 00, 00, 00, 00, 00, 00, 00, 00, 00, 00, 00, 00, 00, 00, 00, 00, 00, 00, 00, 00, 00, 00, 00, 00, 00, 00, 00, 00, 00, 00, 00, 00, 00, 00, 04, 00, 00, 00, 00, 01, 01, 01, 01], 
			[01, 00, 00, 06, 00, 00, 00, 00, 00, 00, 00, 00, 00, 00, 00, 00, 00, 00, 00, 00, 00, 00, 00, 00, 00, 00, 00, 00, 00, 00, 00, 00, 00, 00, 01, 01, 01, 01, 00, 00, 00, 00, 00, 00, 00, 00, 00, 00, 00, 01, 01, 01, 00, 01], 
			[01, 00, 02, 03, 02, 00, 00, 00, 00, 00, 00, 00, 00, 00, 01, 01, 01, 01, 01, 00, 00, 00, 00, 00, 00, 00, 00, 00, 00, 00, 00, 00, 01, 01, 01, 00, 00, 01, 01, 00, 00, 00, 00, 00, 00, 00, 00, 01, 01, 01, 00, 00, 00, 01], 
			[01, 00, 00, 00, 00, 00, 00, 00, 00, 00, 00, 00, 00, 01, 01, 00, 00, 00, 01, 01, 00, 00, 00, 00, 00, 00, 00, 00, 00, 00, 00, 00, 01, 00, 00, 00, 00, 00, 01, 01, 01, 00, 00, 00, 00, 00, 01, 01, 00, 00, 00, 00, 00, 01], 
			[01, 00, 00, 00, 00, 00, 00, 00, 01, 01, 01, 01, 01, 01, 00, 00, 00, 00, 00, 01, 00, 00, 00, 00, 00, 00, 00, 00, 00, 00, 00, 00, 01, 01, 01, 01, 01, 01, 01, 00, 01, 00, 00, 00, 00, 00, 01, 00, 00, 00, 00, 00, 00, 01], 
			[01, 00, 00, 00, 00, 00, 00, 00, 01, 00, 00, 00, 00, 00, 00, 00, 00, 00, 00, 01, 00, 00, 00, 00, 00, 00, 00, 00, 00, 00, 00, 00, 00, 00, 00, 00, 00, 00, 01, 00, 01, 01, 00, 00, 00, 00, 01, 01, 00, 00, 00, 00, 00, 01], 
			[01, 00, 00, 00, 00, 00, 00, 00, 01, 01, 00, 00, 00, 00, 00, 00, 00, 00, 01, 01, 00, 00, 00, 00, 00, 00, 00, 00, 00, 00, 00, 00, 00, 00, 00, 00, 00, 01, 01, 01, 00, 01, 00, 00, 00, 00, 00, 01, 00, 00, 00, 00, 00, 01], 
			[01, 00, 00, 00, 00, 00, 00, 00, 01, 01, 00, 00, 00, 00, 00, 00, 00, 00, 00, 01, 00, 00, 00, 00, 00, 00, 00, 00, 00, 00, 00, 00, 00, 00, 00, 00, 00, 00, 01, 01, 01, 01, 01, 00, 00, 00, 00, 01, 01, 01, 00, 00, 00, 01], 
			[01, 00, 00, 00, 00, 00, 00, 00, 01, 00, 00, 00, 00, 00, 00, 00, 00, 00, 01, 01, 00, 00, 00, 00, 00, 00, 00, 00, 00, 00, 00, 00, 00, 00, 00, 00, 00, 00, 00, 00, 00, 01, 01, 01, 00, 00, 00, 00, 01, 01, 01, 01, 01, 01], 
			[01, 00, 00, 00, 00, 00, 00, 00, 01, 01, 00, 00, 00, 00, 00, 00, 00, 01, 01, 00, 00, 00, 00, 00, 00, 00, 00, 00, 00, 00, 00, 00, 00, 00, 00, 00, 00, 00, 00, 00, 01, 01, 01, 01, 01, 00, 00, 00, 00, 00, 01, 01, 01, 01], 
			[01, 00, 00, 00, 00, 00, 00, 00, 01, 01, 00, 00, 00, 00, 00, 00, 00, 01, 00, 00, 00, 00, 00, 00, 00, 00, 00, 00, 00, 00, 00, 00, 00, 00, 00, 00, 00, 00, 00, 00, 01, 00, 00, 01, 01, 00, 00, 00, 00, 00, 00, 00, 00, 01], 
			[01, 00, 00, 00, 00, 00, 00, 00, 01, 00, 00, 00, 00, 00, 00, 00, 00, 01, 00, 00, 00, 00, 00, 00, 00, 00, 00, 00, 00, 00, 00, 00, 00, 00, 00, 00, 00, 00, 00, 01, 00, 00, 00, 00, 00, 01, 00, 00, 00, 00, 00, 00, 00, 01], 
			[01, 00, 00, 00, 00, 00, 00, 00, 01, 01, 01, 00, 00, 00, 00, 00, 00, 01, 00, 00, 00, 00, 00, 00, 00, 00, 00, 00, 00, 00, 00, 00, 00, 00, 00, 00, 00, 00, 00, 01, 00, 00, 00, 00, 00, 01, 00, 00, 00, 00, 00, 00, 00, 01], 
			[01, 01, 00, 00, 00, 00, 00, 00, 00, 00, 01, 01, 00, 00, 00, 00, 00, 01, 00, 00, 00, 00, 00, 00, 00, 00, 00, 00, 00, 00, 00, 00, 00, 00, 00, 00, 00, 00, 00, 01, 00, 00, 00, 00, 00, 01, 00, 00, 00, 00, 00, 00, 00, 01], 
			[01, 01, 00, 00, 00, 23, 00, 00, 00, 00, 00, 01, 01, 01, 01, 01, 01, 01, 00, 00, 00, 00, 00, 00, 00, 00, 00, 08, 00, 00, 00, 00, 00, 00, 00, 00, 00, 00, 00, 01, 00, 00, 00, 00, 00, 01, 00, 00, 00, 00, 00, 00, 00, 01], 
			[00, 01, 01, 00, 00, 00, 00, 00, 00, 00, 00, 00, 00, 00, 01, 01, 00, 00, 00, 00, 00, 00, 00, 00, 00, 00, 00, 00, 00, 00, 00, 00, 00, 00, 00, 00, 00, 00, 00, 00, 01, 00, 00, 00, 01, 01, 00, 00, 00, 00, 00, 00, 00, 01], 
			[00, 01, 01, 01, 00, 00, 00, 00, 00, 00, 00, 00, 00, 00, 00, 00, 00, 00, 00, 00, 00, 00, 00, 00, 00, 00, 00, 11, 00, 00, 00, 00, 00, 00, 00, 00, 00, 00, 00, 00, 01, 01, 01, 01, 01, 00, 00, 00, 00, 00, 00, 00, 00, 01], 
			[00, 01, 01, 00, 00, 00, 00, 00, 00, 00, 00, 00, 00, 00, 00, 00, 00, 00, 00, 00, 00, 00, 00, 00, 00, 00, 00, 00, 00, 00, 00, 00, 00, 00, 00, 00, 00, 00, 00, 00, 00, 00, 00, 00, 00, 00, 00, 00, 00, 00, 00, 00, 00, 01], 
			[01, 01, 00, 00, 00, 00, 00, 00, 00, 00, 00, 00, 00, 00, 00, 00, 00, 00, 00, 00, 00, 00, 00, 00, 00, 00, 00, 00, 00, 00, 00, 00, 00, 00, 00, 00, 00, 00, 00, 00, 00, 00, 00, 00, 00, 00, 00, 00, 00, 00, 00, 01, 01, 01], 
			[01, 00, 00, 00, 00, 00, 00, 00, 00, 00, 00, 00, 00, 00, 00, 00, 00, 00, 00, 00, 00, 00, 00, 00, 00, 00, 99, 00, 00, 00, 00, 00, 00, 00, 00, 00, 01, 01, 01, 00, 00, 00, 00, 00, 00, 00, 00, 00, 00, 01, 01, 01, 01, 01], 
			[01, 00, 00, 00, 00, 00, 00, 00, 00, 00, 00, 01, 01, 01, 01, 01, 01, 01, 01, 00, 00, 00, 00, 00, 00, 00, 00, 00, 00, 00, 00, 00, 00, 00, 01, 01, 01, 00, 01, 01, 01, 00, 00, 00, 00, 00, 00, 00, 00, 01, 01, 00, 00, 00], 
			[01, 00, 00, 00, 00, 00, 00, 00, 00, 00, 01, 01, 00, 00, 00, 00, 00, 00, 01, 01, 00, 00, 00, 00, 00, 00, 00, 00, 00, 00, 00, 00, 00, 01, 01, 00, 00, 00, 00, 00, 00, 01, 00, 00, 00, 00, 00, 00, 00, 01, 00, 00, 00, 00], 
			[01, 00, 00, 00, 00, 00, 00, 00, 00, 01, 01, 00, 00, 00, 00, 00, 00, 00, 00, 01, 01, 00, 00, 00, 00, 00, 00, 00, 00, 00, 00, 00, 00, 00, 01, 01, 00, 00, 00, 00, 00, 01, 00, 00, 00, 00, 00, 00, 01, 01, 00, 00, 00, 00], 
			[01, 00, 00, 00, 00, 00, 00, 00, 00, 01, 00, 00, 00, 00, 00, 00, 00, 00, 00, 00, 01, 01, 00, 00, 00, 00, 00, 00, 00, 00, 00, 00, 00, 00, 00, 01, 01, 01, 00, 00, 00, 01, 00, 00, 00, 00, 00, 00, 01, 01, 00, 00, 00, 00], 
			[01, 02, 03, 02, 00, 00, 00, 00, 00, 01, 01, 00, 01, 01, 01, 01, 01, 01, 00, 00, 00, 01, 01, 01, 00, 00, 00, 00, 00, 00, 00, 00, 00, 00, 00, 00, 01, 00, 01, 00, 00, 01, 00, 00, 00, 00, 00, 00, 00, 01, 00, 00, 00, 00],
			[01, 00, 00, 00, 00, 00, 00, 00, 00, 00, 01, 01, 01, 00, 00, 00, 00, 01, 00, 00, 00, 00, 00, 01, 00, 00, 00, 00, 00, 00, 00, 00, 00, 00, 00, 00, 01, 00, 01, 00, 00, 01, 00, 00, 00, 00, 00, 00, 00, 01, 00, 00, 00, 00],
			[01, 00, 00, 00, 00, 00, 00, 00, 00, 00, 00, 00, 00, 00, 00, 00, 00, 01, 01, 01, 00, 00, 00, 01, 01, 01, 01, 00, 00, 00, 00, 00, 00, 00, 00, 00, 01, 01, 00, 00, 00, 01, 00, 00, 00, 00, 00, 00, 00, 01, 01, 00, 00, 00],
			[01, 01, 01, 01, 00, 00, 00, 00, 00, 00, 00, 00, 00, 00, 00, 00, 00, 00, 00, 01, 00, 00, 00, 00, 00, 00, 01, 01, 01, 01, 01, 00, 00, 00, 00, 00, 01, 01, 01, 00, 00, 01, 00, 00, 00, 00, 00, 00, 00, 00, 01, 00, 00, 00],
			[00, 00, 01, 01, 01, 01, 00, 00, 00, 00, 00, 00, 00, 00, 00, 00, 00, 00, 00, 01, 01, 01, 01, 00, 00, 00, 00, 00, 01, 01, 01, 00, 00, 00, 00, 00, 00, 01, 01, 00, 01, 01, 00, 00, 00, 00, 00, 00, 00, 00, 01, 00, 00, 00],
			[00, 00, 00, 00, 01, 01, 00, 00, 00, 00, 00, 00, 00, 00, 00, 00, 00, 00, 00, 00, 00, 00, 01, 01, 00, 00, 00, 00, 00, 00, 01, 00, 00, 00, 00, 00, 00, 00, 00, 01, 01, 00, 00, 00, 00, 00, 00, 00, 00, 00, 01, 00, 00, 00],
			[00, 00, 00, 00, 00, 01, 01, 01, 01, 00, 00, 00, 00, 00, 00, 00, 00, 00, 00, 00, 00, 00, 00, 01, 01, 00, 00, 00, 00, 00, 01, 00, 00, 00, 00, 00, 00, 00, 00, 00, 00, 00, 00, 00, 00, 00, 00, 00, 00, 00, 01, 00, 00, 00],
			[00, 00, 00, 00, 00, 00, 00, 01, 01, 01, 00, 00, 00, 00, 00, 00, 00, 00, 00, 00, 00, 00, 00, 00, 01, 01, 00, 01, 01, 01, 01, 01, 00, 00, 00, 00, 00, 00, 00, 00, 00, 00, 00, 00, 00, 00, 00, 00, 00, 01, 01, 00, 00, 00], 
			[00, 00, 00, 00, 00, 00, 00, 00, 01, 01, 01, 01, 01, 01, 00, 00, 00, 00, 00, 00, 00, 00, 00, 00, 00, 01, 01, 01, 01, 01, 01, 00, 00, 00, 00, 00, 00, 00, 00, 00, 00, 00, 00, 00, 00, 00, 00, 00, 00, 01, 00, 00, 00, 00], 
			[00, 00, 00, 00, 00, 00, 00, 00, 00, 00, 00, 00, 01, 01, 01, 01, 00, 00, 00, 00, 00, 00, 00, 00, 00, 00, 00, 00, 01, 01, 01, 00, 00, 00, 00, 00, 00, 00, 00, 00, 00, 00, 00, 00, 00, 00, 01, 01, 01, 01, 00, 00, 00, 00], 
			[00, 00, 00, 00, 00, 00, 00, 00, 00, 00, 00, 00, 00, 00, 01, 01, 01, 01, 01, 01, 01, 01, 00, 00, 00, 00, 00, 00, 00, 00, 00, 00, 00, 00, 00, 00, 00, 00, 00, 00, 00, 00, 00, 00, 00, 01, 01, 00, 00, 01, 00, 00, 00, 00], 
			[00, 00, 00, 00, 00, 00, 00, 00, 00, 00, 00, 00, 00, 00, 00, 00, 00, 00, 00, 00, 01, 01, 01, 01, 01, 00, 00, 00, 00, 00, 00, 00, 00, 00, 00, 00, 00, 00, 00, 00, 00, 00, 00, 00, 00, 01, 00, 00, 00, 00, 00, 00, 00, 00], 
			[00, 00, 00, 00, 00, 00, 00, 00, 00, 00, 00, 00, 00, 00, 00, 00, 00, 00, 00, 00, 00, 00, 00, 01, 01, 01, 00, 00, 00, 00, 00, 00, 00, 00, 00, 00, 00, 00, 00, 00, 00, 00, 00, 00, 01, 01, 00, 00, 00, 00, 00, 00, 00, 00], 
			[00, 00, 00, 00, 00, 00, 00, 00, 00, 00, 00, 00, 00, 00, 00, 00, 00, 00, 00, 00, 00, 00, 00, 00, 01, 01, 01, 00, 00, 00, 01, 01, 01, 01, 01, 01, 01, 01, 01, 01, 01, 01, 01, 01, 01, 00, 00, 00, 00, 00, 00, 00, 00, 00], 
			[00, 00, 00, 00, 00, 00, 00, 00, 00, 00, 00, 00, 00, 00, 00, 00, 00, 00, 00, 00, 00, 00, 00, 00, 01, 01, 01, 00, 00, 00, 01, 00, 00, 00, 00, 00, 00, 00, 00, 00, 00, 00, 00, 00, 00, 00, 00, 00, 00, 00, 00, 00, 00, 00],
			[00, 00, 00, 00, 00, 00, 00, 00, 00, 00, 00, 00, 00, 00, 00, 00, 00, 00, 00, 00, 00, 00, 00, 00, 00, 01, 01, 01, 01, 01, 01, 00, 00, 00, 00, 00, 00, 00, 00, 00, 00, 00, 00, 00, 00, 00, 00, 00, 00, 00, 00, 00, 00, 00]];